XXXXXXXXXXXXXXXX  XXXXXXXXXXXXXXXXXXXXXX
XXXXXXXXXXXXXXXX  XXXXXXXXXXXXXXXXXXXXXX
XXXXXXXXXXXXXXXXX  XXXXXXXXXXXXXXXXXXXXX
XXXXXXXXXXX   XXXX  XXXXXXX     XXXXXXXX
XXXXXXXXXXX    XXXX  XXXXXX  XXXXXXXXXXX
XXXX            XXXX  XXXXX  XXXXXXXXXXX
XXXXXXXXXXXXXX  XXXX         XXXXXXXXXXX
XXXXXXXXXXXXXX  XXXX  XXXXXXXXXXXXXXXXXX
XXXXXXXXXXXX          XXXXXXXXXXXXXXXXXX
XXXX    XXXX   XXXXX  XXXXXXXXXXXXXXXXXX
XXXX              XXXXXXXXXXXXXXXXXXXXXX
XXXXXXXX  XXXXXX        XXXXXXXXXXXXXXXX
XXXXXXXX    XXXXXXXXXX  XXXXXXXXXXXXXXXX
XXXXXXXXXXXXXXXXXXXXXX        XXXXXXXXXX
X                                      X
XXXXX  XXXX  XXXX  XXXX  XXXXX  XXXXXXXX
